C 135,206,250

F 92,92,92
NO textures/north_wall.xpm
SO textures/south_wall.xpm


WE        textures/west_wall.xpm
EA textures/east_wall.xpm

1111111111111111
10000000000000001
1000000000000000011111111111111
10000000000000000000000000000001
11111111111111100000000000000W01
               10000000000000001
1111111111111110011100011111111
10000000000000000000001
10000000000000000000001
1000000000000000111111
1111111111111111